111111111111111111111111111111111111111111111111111111111111111111111111111111
10010C0000C0000000000000000000000000000000000000000000000000000000000000000001
100001111100000000000000000000000000000000000000000000000000000000000000000001
1P0011E00L0C000000000000000000000111111000000000000000000000000000000000000001
100000000000000000000000000000000000000000000000000000000000000000000000000001
100000000000000000000000000000000000000000000000111000000000000000000000000001
100000000000000000000000000000000000000000000000000000000000000000000000000001
100000000111100000000000000000000000000000000000000000000000000000000000000001
100000000000000000000000000000000000000000000000000000000000000000000000000001
100000000000000000000000000000000000000000000000000000000000000000000000000001
100000000000000000000000000000000000000000000000000000000000000000000000000001
100000000000000000000000000111111000000000000000000000000000000000000000000001
100000000000000000000000000000000000000000000000000000000000000000000000000001
100000000000000000000000000000000000000000000001111111111100000000000000000001
100000000000001111100000000000000000000000000000000000000000000000000000000001
100000000000000000000000000000000000000000000000000000000000000000000000000001
111111111111111111111111111111111111111111111111111111111111111111111111111111
