1111111111111
10000000C0001
1P00001E01111
100001C100L11
11111010C0001
10000C0000001
1111111111111
