1111111111111
10000000C0001
1P30300E01111
100000C000L11
11111000C0001
10000C0000001
1111111111111
