1111111111111
1CCCCCCCCCCC1
1CCCCCCECCCC1
1CCCCCCCCCCC1
1CCCCCCCCCCC1
1PCCCCCCCCCC1
1111111111111
