1111111111111
10000000C0001
1000000E01111
100000C000L11
11111C00C0001
1P00000000001
1111111111111
