1111111111111
1000000000001
1P00000E01111
1000000000L11
1111100000001
1000000000001
1111111111111
