111111111111111111
1C0000000000000001
100000000000000001
111111111111111111
10L00000000000P001
1000E0000000000001
111111111111111111
